2003
Tournament Go 4	Smasher:Ken	Marth (SSBM)
Tournament Go 5	Smasher:Ken	Marth (SSBM)
2004
Game Over (tournament)	Smasher:Ken	Marth (SSBM)	Captain Falcon (SSBM)
MELEE-FC1	Smasher:Ken	Marth (SSBM)
Tournament Go 6	Smasher:Azen	Marth (SSBM)	Sheik (SSBM)
MLG New York 2004	Smasher:Ken	Marth (SSBM)
2005
MOAST 3	Smasher:Isai	Captain Falcon (SSBM)
MLG DC 2005	Smasher:Ken	Marth (SSBM)
MLG San Francisco 2005	Smasher:Ken	Marth (SSBM)
Gettin' Schooled 2	Smasher:Ken	Marth (SSBM)
MELEE-FC3	Smasher:Ken	Marth (SSBM)
Jack Garden Tournament	Smasher:Ken	Marth (SSBM)
BOMB 4	Smasher:ChuDat	Ice Climbers (SSBM)
2006
MLG New York 2005	Smasher:Ken	Marth (SSBM)
MLG New York Opener 2006	Smasher:PC Chris	Falco (SSBM)	Marth (SSBM)
MLG Dallas 2006	Smasher:Ken	Marth (SSBM)
MLG Anaheim 2006	Smasher:Ken	Marth (SSBM)	Captain Falcon (SSBM)
MELEE-FC6	Smasher:PC Chris	Falco (SSBM)	Fox (SSBM)	Sheik (SSBM)
MLG Chicago 2006	Smasher:Ken	Marth (SSBM)
Zero Challenge 2	Smasher:Ken	Marth (SSBM)	Fox (SSBM)
MLG Orlando 2006	Smasher:Azen	Marth (SSBM)	Captain Falcon (SSBM)
MLG New York Playoffs 2006	Smasher:Azen	Marth (SSBM)	Falco (SSBM)	Captain Falcon (SSBM)	Sheik (SSBM)
MLG Las Vegas 2006	Smasher:PC Chris	Falco (SSBM)	Fox (SSBM)
2007
Cataclysm 3	Smasher:Mew2King	Fox (SSBM)	Marth (SSBM)
Pound 2	Smasher:ChuDat	Ice Climbers (SSBM)
The Renaissance of Smash 4	Smasher:Amsah	Sheik (SSBM)	Marth (SSBM)
MELEE-FC Diamond	Smasher:Mew2King	Marth (SSBM)
Zero Challenge 3	Smasher:PC Chris	Fox (SSBM)	Falco (SSBM)	Peach (SSBM)	Sheik (SSBM)
EVO West	Smasher:Mew2King	Marth (SSBM)
EVO World 2007	Smasher:Ken	Marth (SSBM)
Super Champ Combo	Smasher:Mew2King	Marth (SSBM)	Fox (SSBM)	Falco (SSBM)
Viva La Smashtaclysm	Smasher:Azen	Marth (SSBM)	Captain Falcon (SSBM)	Peach (SSBM)	Sheik (SSBM)	Link (SSBM)
2008
Pound 3	Smasher:Mango	Jigglypuff (SSBM)	Fox (SSBM)
Epita Smash Arena 2	Smasher:Amsah	Sheik (SSBM)
2009
Revival of Melee	Smasher:Mango	Jigglypuff (SSBM)	Falco (SSBM)	Captain Falcon (SSBM)
SMASH ATTACK	Smasher:Armada	Peach (SSBM)
Epita Smash Arena 3	Smasher:Armada	Peach (SSBM)
GENESIS	Smasher:Mango	Jigglypuff (SSBM)	Falco (SSBM)
Revival of Melee 2	Smasher:Hungrybox	Jigglypuff (SSBM)
2010
Pound 4	Smasher:Mango	Jigglypuff (SSBM)	Falco (SSBM)
Apex 2010	Smasher:Hungrybox	Jigglypuff (SSBM)
Smash Needs You	Smasher:Armada	Peach (SSBM)
Revival of Melee 3	Smasher:PPMD	Falco (SSBM)
2011
B.E.A.S.T	Smasher:Armada	Peach (SSBM)
Pound V	Smasher:PPMD	Falco (SSBM)
GENESIS 2	Smasher:Armada	Peach (SSBM)	Young Link (SSBM)
B.E.A.S.T II	Smasher:Armada	Peach (SSBM)
Revival of Melee 4	Smasher:Mango	Falco (SSBM)	Fox (SSBM)
2012
Apex 2012	Smasher:Armada	Peach (SSBM)	Young Link (SSBM)
IMPULSE	Smasher:Mango	Falco (SSBM)	Fox (SSBM)
Smashers' Reunion: Melee Grande	Smasher:Armada	Peach (SSBM)
MELEE-FC10R Legacy	Smasher:Mango	Fox (SSBM)	Captain Falcon (SSBM)	Falco (SSBM)
The Big House 2	Smasher:Mango	Fox (SSBM)	Falco (SSBM)	Captain Falcon (SSBM)
Kings of Cali	Smasher:PPMD	Falco (SSBM)
2013
Apex 2013	Smasher:Armada	Peach (SSBM)	Young Link (SSBM)
B.E.A.S.T 3	Smasher:Mango	Falco (SSBM)
Zenith 2013	Smasher:Mango	Fox (SSBM)	Falco (SSBM)
EVO 2013	Smasher:Mango	Fox (SSBM)	Falco (SSBM)
The Big House 3	Smasher:Mew2King	Sheik (SSBM)	Fox (SSBM)	Marth (SSBM)
Revival of Melee 6	Smasher:Mew2King	Fox (SSBM)	Sheik (SSBM)
Kings of Cali 3	Smasher:Mew2King	Sheik (SSBM)	Peach (SSBM)	Marth (SSBM)	Fox (SSBM)	Mewtwo (SSBM)
2014
Apex 2014	Smasher:PPMD	Falco (SSBM)	Marth (SSBM)
B.E.A.S.T 4	Smasher:Leffen	Fox (SSBM)
Revival of Melee 7	Smasher:Mango	Fox (SSBM)	Falco (SSBM)
Get On My Level 2014	Smasher:Mango	Falco (SSBM)	Fox (SSBM)
Republic of Fighters 3	Smasher:Leffen	Fox (SSBM)
Pat's House 2	Smasher:Mew2King	Sheik (SSBM)	Fox (SSBM)	Marth (SSBM)
SKTAR 3	Smasher:PPMD	Falco (SSBM)	Marth (SSBM)
Super SWEET	Smasher:Armada	Peach (SSBM)
MLG Anaheim 2014	Smasher:Mango	Sheik (SSBM)	Marth (SSBM)	Fox (SSBM)
CEO 2014	Smasher:Armada	Peach (SSBM)	Young Link (SSBM)
Kings of Cali 4	Smasher:Mango	Fox (SSBM)	Falco (SSBM)
EVO 2014	Smasher:Mango	Fox (SSBM)
Zenith 2014	Smasher:Mew2King	Sheik (SSBM)	Marth (SSBM)	Peach (SSBM)
Tipped Off 10	Smasher:Hungrybox	Jigglypuff (SSBM)
The Big House 4	Smasher:Mango	Fox (SSBM)	Falco (SSBM)	Captain Falcon (SSBM)	Marth (SSBM)
Do You Fox Wit It?	Smasher:Hax	Fox (SSBM)
Forte 2	Smasher:Hungrybox	Jigglypuff (SSBM)
2015
B.E.A.S.T 5	Smasher:Leffen	Fox (SSBM)
Paragon Orlando 2015	Smasher:Hungrybox	Jigglypuff (SSBM)
Apex 2015	Smasher:PPMD	Marth (SSBM)	Falco (SSBM)
I'm Not Yelling!	Smasher:Armada	Fox (SSBM)	Peach (SSBM)
Sandstorm	Smasher:Armada	Peach (SSBM)	Fox (SSBM)
Dr√∏mmeLAN 4.5	Smasher:Armada	Fox (SSBM)
Press Start	Smasher:Mango	Fox (SSBM)	Falco (SSBM)
Battle Arena Melbourne 7	Smasher:Mango	Falco (SSBM)	Captain Falcon (SSBM)	Fox (SSBM)
Get On My Level 2015	Smasher:Hungrybox	Jigglypuff (SSBM)
Smash 'N' Splash	Smasher:Mew2King	Sheik (SSBM)	Marth (SSBM)
CEO 2015	Smasher:Leffen	Fox (SSBM)
FC Smash 15XR: Return	Smasher:Leffen	Fox (SSBM)
WTFox	Smasher:Leffen	Fox (SSBM)
EVO 2015	Smasher:Armada	Peach (SSBM)	Fox (SSBM)
Super Smash Con 2015	Smasher:Leffen	Fox (SSBM)
Heir II the Throne	Smasher:Armada	Sheik (SSBM)	Falco (SSBM)	Young Link (SSBM)	Marth (SSBM)
PAX Prime 2015	Smasher:Mew2King	Sheik (SSBM)	Marth (SSBM)	Fox (SSBM)
Paragon Los Angeles 2015	Smasher:Mango	Falco (SSBM)	Fox (SSBM)
HTC Throwdown	Smasher:Leffen	Fox (SSBM)
Helix	Smasher:Armada	Peach (SSBM)	Fox (SSBM)
The Big House 5	Smasher:Armada	Peach (SSBM)	Fox (SSBM)
MLG World Finals 2015	Smasher:Hungrybox	Jigglypuff (SSBM)
Smash Summit	Smasher:Armada	Peach (SSBM)	Fox (SSBM)
Eclipse	Smasher:Armada	Fox (SSBM)	Peach (SSBM)
DreamHack Winter 2015	Smasher:Hungrybox	Jigglypuff (SSBM)
2016
GENESIS 3	Smasher:Armada	Peach (SSBM)	Fox (SSBM)
PAX Arena	Smasher:Hungrybox	Jigglypuff (SSBM)
B.E.A.S.T 6	Smasher:Armada	Peach (SSBM)	Fox (SSBM)
Battle of the Five Gods	Smasher:Hungrybox	Jigglypuff (SSBM)
Pound 2016	Smasher:Hungrybox	Jigglypuff (SSBM)
Smash Summit 2	Smasher:Armada	Peach (SSBM)	Fox (SSBM)
Enthusiast Gaming Live Expo	Smasher:Hungrybox	Jigglypuff (SSBM)
DreamHack Austin 2016	Smasher:Mango	Fox (SSBM)	Falco (SSBM)
Get On My Level 2016	Smasher:Leffen	Fox (SSBM)
Smash 'N' Splash 2	Smasher:Hungrybox	Jigglypuff (SSBM)
Low Tier City 4	Smasher:Hungrybox	Jigglypuff (SSBM)
CEO 2016	Smasher:Hungrybox	Jigglypuff (SSBM)
WTFox 2	Smasher:Mango	Marth (SSBM)	Fox (SSBM)
EVO 2016	Smasher:Hungrybox	Jigglypuff (SSBM)
Clutch City Clash	Smasher:Mew2King	Marth (SSBM)	Sheik (SSBM)
Super Smash Con 2016	Smasher:Mango	Fox (SSBM)	Falco (SSBM)
Heir 3	Smasher:Armada	Peach (SSBM)
Shine 2016	Smasher:Mew2King	Marth (SSBM)	Sheik (SSBM)	Peach (SSBM)
Syndicate 2016	Smasher:Armada	Peach (SSBM)
The Big House 6	Smasher:Mango	Fox (SSBM)	Falco (SSBM)
Eclipse 2	Smasher:Armada	Peach (SSBM)
Canada Cup 2016	Smasher:Armada	Peach (SSBM)	Fox (SSBM)
Smash Summit 3	Smasher:Armada	Peach (SSBM)	Fox (SSBM)
DreamHack Winter 2016	Smasher:Armada	Fox (SSBM)	Peach (SSBM)
UGC Smash Open	Smasher:Armada	Peach (SSBM)	Fox (SSBM)
Don't Park on the Grass	Smasher:Leffen	Fox (SSBM)
2017
GENESIS 4	Smasher:Armada	Peach (SSBM)
B.E.A.S.T 7	Smasher:Armada	Fox (SSBM)	Peach (SSBM)
Smash Summit Spring 2017	Smasher:Armada	Fox (SSBM)	Peach (SSBM)
Frame Perfect Series 2	Smasher:Hungrybox	Jigglypuff (SSBM)
Full Bloom 3	Smasher:Hungrybox	Jigglypuff (SSBM)
Smash Rivalries	Smasher:Hungrybox	Jigglypuff (SSBM)
CEO Dreamland	Smasher:Mew2King	Marth (SSBM)	Fox (SSBM)	Sheik (SSBM)
HFLAN Melee Edition 2017	Smasher:Armada	Peach (SSBM)
DreamHack Austin 2017	Smasher:Hungrybox	Jigglypuff (SSBM)
Royal Flush (tournament)	Smasher:Mango	Falco (SSBM)	Fox (SSBM)
Smash 'N' Splash 3	Smasher:Hungrybox	Jigglypuff (SSBM)
Battle of BC 2	Smasher:ChuDat	Ice Climbers (SSBM)
CEO 2017	Smasher:Hungrybox	Jigglypuff (SSBM)
Bad Moon Rising 2	Smasher:Hungrybox	Jigglypuff (SSBM)
EVO 2017	Smasher:Armada	Peach (SSBM)
DreamHack Atlanta 2017	Smasher:Plup	Sheik (SSBM)	Fox (SSBM)
Get On My Level 2017	Smasher:Leffen	Fox (SSBM)
Super Smash Con 2017	Smasher:Mango	Falco (SSBM)
Heir 4	Smasher:Leffen	Fox (SSBM)
Shine 2017	Smasher:Hungrybox	Jigglypuff (SSBM)
Syndicate 2017	Smasher:Armada	Peach (SSBM)
GameTyrant Expo 2017	Smasher:Hungrybox	Jigglypuff (SSBM)
The Big House 7	Smasher:Hungrybox	Jigglypuff (SSBM)
DreamHack Denver 2017	Smasher:Hungrybox	Jigglypuff (SSBM)
Canada Cup 2017	Smasher:Mew2King	Marth (SSBM)	Sheik (SSBM)
Too Hot to Handle	Smasher:Hungrybox	Jigglypuff (SSBM)
Smash Summit 5	Smasher:Hungrybox	Jigglypuff (SSBM)
2018
Valhalla	Smasher:Leffen	Fox (SSBM)	Marth (SSBM)
